Abuna's Chant	choose
Acorn Harvest	flashback
Active Volcano	choose
Adarkar Unicorn	mana pool
Aeon Chronicler	suspend
Aether Burst	multiple targets
Aether Shockwave	choose
Afflicted Deserter	transform
Agent of Stromhald	mana pool
Akki Rockspeaker	mana pool
Akroma, Angel of Fury	morph
Alabaster Leech	cost modification
Alabaster Potion	choose
All Sun's Dawn	multiple targets
Altar of Shadows	mana pool
Altar of the Lost	mana pool
Alter Reality	flashback
An-Havva Township	mana pool
Ancestral Tribute	flashback
Ancestral Vision	suspend
Ancient Grudge	flashback
Ancient Spring	mana pool
Ancient Stirrings	reveal
Ancient Tomb	mana pool
Andradite Leech	cost modification
Angel of Salvation	convoke
Angel of Serenity	multiple targets
Animar, Soul of the Elements	cost modification
Anthousa, Setassan Hero	multiple targets
Aphetto Alchemist	morph
Aphetto Dredging	multiple targets
Aphetto Exterminator	morph
Appetite for Brains	reveal
Apprentice Wizard	mana pool
Aquamorph Entity	morph
Arc Blade	suspend
Arcane Melee	cost modification
Archon of the Triumvirate	multiple targets
Army of the Damned	flashback
Artful Dodge	flashback
Artisan's Sorrow	scry > 1
Ascending Aven	morph
Ash Zealot	from graveyard
Ashnod's Altar	mana pool
Astral Cornucopia	mana pool
Astrolabe	mana pool
Atalya, Samite Healer	choose
Augur of Bolas	reveal
Augury Owl	scry > 1
Aura of Silence	cost modification
Austere Command	choose
Autochthon Wurm	convoke
Aven Augur	multiple targets
Aven Liberator	morph
Axebane Guardian	mana pool
Aysen Abbey	mana pool
Azorius Chancery	mana pool
Azorius Charm	choose
Azorius Justicar	multiple targets
Azorius Signet	mana pool
Backslide	morph
Balduvian Trading Post	mana pool
Ballyrush Banneret	cost modification
Bamboozle	multiple targets
Bane of Hanweir	transform
Bane of the Living	morph
Bant Charm	choose
Barbed Lightning	choose
Barrin's Spite	multiple targets
Basal Sliver	mana pool
Basal Thrull	mana pool
Basalt Monolith	mana pool
Bash to Bits	flashback
Battering Craghorn	morph
Battle Hymn	mana pool
Battle Screech	flashback
Beast Attack	flashback
Benalish Commander	suspend
Betrayal of Flesh	choose
Birchlore Rangers	morph
Black Lotus	mana pool
Black Mana Battery	mana pool
Black Market	mana pool
Blades of Velis Vel	multiple targets
Blasphemous Act	cost modification
Blightsteel Colossus	reveal
Blinding Beam	choose
Blinkmoth Urn	mana pool
Blistering Firecat	morph
Blood Celebrant	mana pool
Blood Funnel	cost modification
Blood Moon	becomes basic land
Blood Vassal	mana pool
Bloodghast	from graveyard
Bloodline Keeper	transform
Bloodstoke Howler	morph
Bloom Tender	mana pool
Blue Elemental Blast	choose
Blue Mana Battery	mana pool
Bog Initiate	mana pool
Bog Witch	mana pool
Boneknitter	morph
Boros Battleshaper	multiple targets
Boros Charm	choose
Boros Garrison	mana pool
Boros Signet	mana pool
Bosk Banneret	cost modification
Bottomless Vault	mana pool
Bow of Nylea	choose
Braid of Fire	mana pool
Branching Bolt	choose
Branchsnap Lorian	morph
Brighthearth Banneret	cost modification
Brightstone Ritual	mana pool
Brine Elemental	morph
Broodhatch Nantuko	morph
Brutalizer Exarch	choose
Bubbling Muck	mana pool
Bump in the Night	from graveyard
Burning Oil	flashback
Burning Wish	reveal
Burning-Tree Emissary	mana pool
Burnt Offering	mana pool
Cabal Coffers	mana pool
Cabal Excutioner	morph
Cabal Ritual	mana pool
Cabal Therapy	flashback
Cackling Counterpart	flashback
Cadaverous Bloom	mana pool
Caged Sun	mana pool
Calciform Pools	mana pool
Call of the Herd	flashback
Cannibalize	multiple targets
Canopy Claws	flashback
Capricious Efreet	multiple targets
Carnival of Souls	mana pool
Carpet of Flowers	mana pool
Carrion Beetles	multiple targets
Cascade Bluffs	mana pool
Castle Sengir	mana pool
Cathodian	mana pool
Cauldron Haze	multiple targets
Cauldron of Souls	multiple targets
Cavern of Souls	restricted mana
Celestial Gatekeeper	multiple targets
Celestial Prism	mana pool
Centaur Omenreader	cost modification
Cephalid Constable	multiple targets
Ceta Disciple	mana pool
Chainer's Edict	flashback
Chalice of Life	transform
Chancellor of the Tangle	mana pool
Chandra Pyromaster	multiple targets
Chandra's Phoenix	from graveyard
Channel	mana pool
Channel the Suns	mana pool
Chant of Vitu-Ghazi	convoke
Chaos Charm	choose
Chaos Moon	mana pool
Charging Slateback	morph
Charmed Pendant	mana pool
Chatter of the Squirrel	flashback
Chill	cost modification
Chill of Forboding	flashback
Cho-Arrim Bruiser	multiple targets
Chord of Calling	convoke
Chosen of Markov	transform
Chromatic Sphere	mana pool
Chromatic Star	mana pool
Chromeshell Crab	morph
Chronomantic Escape	suspend
City of Shadows	mana pool
City of Traitors	mana pool
Civilized Scholar	transform
Clan Defiance	choose
Cloistered Youth	transform
Cloud Key	cost modification
Cloudpost	mana pool
Coal Golem	mana pool
Coal Stoker	mana pool
Coalition Relic	mana pool
Coffin Purge	flashback
Composite Golem	mana pool
Conclave Equenaut	convoke
Conclave Phalanx	convoke
Conclave's Blessing	convoke
Condescend	scry > 1
Conflagrate	flashback
Consult the Necrosages	choose
Consuming Bonfire	choose
Contagion Clasp	multiple targets
Contagion Engine	multiple targets
Coordinated Assault	multiple targets
Coral Atoll	mana pool
Coral Trickster	morph
Core Prowler	multiple targets
Corpulent Corpse	suspend
Council of the Absolute	cost modification
Courser of Kruphix	reveal
Creeping Renaissance	flashback
Crippling Fatigue	flashback
Crosis's Attendant	mana pool
Crosis's Charm	choose
Crude Rampart	morph
Cruel Revival	multiple targets
Crush of Wurms	flashback
Crushing Vines	choose
Crypt Ghast	mana pool
Crypt of Agadeem	mana pool
Cryptic Command	choose
Crystal Ball	scry > 1
Crystal Quarry	mana pool
Crystal Vein	mana pool
Culling of the Weak	mana pool
Cultural Exchange	multiple targets
Curse of Death's Hold	enchant player
Curse of the Cabal	suspend
Cutthroat Maneuver	multiple targets
Cyclical Evolution	suspend
Darigaaz's Attendant	mana pool
Darigaaz's Charm	choose
Dark Confidant	reveal
Dark Ritual	mana pool
Darksteel Colossus	reveal
Darkwater Catacombs	mana pool
Darkwater Egg	mana pool
Daru Healer	morph
Daru Lancer	morph
Daru Mender	morph
Daru Sanctifier	morph
Daru Warchief	cost modification
Dauntless Onslaught	multiple targets
Dawn Charm	choose
Dawn to Dusk	choose
Dawn's Reflection	mana pool
Dawning Purist	morph
Daybreak Ranger	transform
Deadbridge Goliath	from graveyard
Deadly Allure	flashback
Deathrite Shaman	mana pool
Decompose	multiple targets
Deconstruct	mana pool
Deep Analysis	flashback
Deep Reconnaissance	flashback
Deep-Sea Kraken	suspend
Defender of the Order	morph
Defense Grid	cost modification
Defy Gravity	flashback
Delay	suspend
Delver of Secrets	transform
Dematerialize	flashback
Denying Wind	multiple targets
Derelor	cost modification
Dermoplasm	morph
Desperate Ravings	flashback
Desperate Ritual	mana pool
Detritivore	suspend
Devil's Play	flashback
Devouring Light	convoke
Dichotomancy	suspend
Dimir Aqueduct	mana pool
Dimir Charm	choose
Dimir Signet	mana pool
Disrupting Pitmage	morph
Divine Congregation	suspend
Divine Reckoning	flashback
Domri Rade	reveal
Dormant Volcano	mana pool
Double Negatice	multiple targets
Doubling Cube	mana pool
Doubling Season	counters replacement
Downpour	multiple targets
Draco	cost modification
Dragonspeaker Shaman	cost modification
Drain Power	mana pool
Dread Return	flashback
Dreadship Reef	mana pool
Dream Chisel	cost modification
Dream Tides	multiple targets
Dream Twist	flashback
Dream's Grip	choose
Dreg Mangler	from graveyard
Dromar's Attendant	mana pool
Dromar's Charm	choose
Druid's Repository	mana pool
Duress	reveal
Durkwood Baloth	suspend
Duskrider Peregrine	suspend
Dust of Moments	choose
Dwarven Blastminer	morph
Dwarven Hold	mana pool
Dwarven Ruins	mana pool
Dwell on the Past	multiple targets
Early Frost	multiple targets
Earth Rift	flashback
Ebon Stronghold	mana pool
Ebonblade Reaper	morph
Ebony Charm	choose
Echo Tracer	morph
Edgewalker	cost modification
Eladamri's Vineyard	mana pool
Elbrus, the Binding Blade	transform
Elderwood Scion	cost modification
Eldrazi Temple	mana pool
Electrolyze	divided damage
Elemental Resonance	mana pool
Elephant Ambush	flashback
Elvish Aberration	mana pool
Elvish Archdruid	mana pool
Elvish Guidance	mana pool
Elvish Spirit Guide	mana pool
Embolden	flashback
Emeral Medallion	cost modification
Emerald Charm	choose
Energy Bolt	choose
Energy Chamber	choose
Energy Tap	mana pool
Engulfing Flames	flashback
Entomber Exarch	choose
Epochrasite	suspend
Errant Ephemeron	suspend
Esper Charm	choose
Etherium Scupltor	cost modification
Etherwrought Page	choose
Everflowing Chalice	mana pool
Everglades	mana pool
Evolution Charm	choose
Exalted Angel	morph
Exiled Doomsayer	cost modification
Extraplanar Lens	mana pool
Eye of Ugin	cost modification
Eyes of the Watcher	scry > 1
Fact or Fiction	separate into piles
Faerie Macabre	multiple targets
Faithless Looting	from graveyard
Fallen Cleric	morph
Famished Ghoul	multiple targets
Farrelite Priest	mana pool
Fatal Lore	multiple targets
Fated Conflagration	scry > 1
Fated Infatuation	scry > 1
Fated Intervention	scry > 1
Fated Retribution	scry > 1
Fated Return	scry > 1
Fathom Seer	morph
Feast of Famine	choose
Feeling of Dread	multiple targets
Fendeep Summoner	multiple targets
Ferocious Charge	scry > 1
Feroz's Ban	cost modification
Fertile Ground	mana pool
Fervant Denial	flashback
Festering March	suspend
Fetid Heath	mana pool
Fever Charm	choose
Fill with Fright	scry > 1
Final Revels	choose
Fire Sprites	mana pool
Fire-Lit Thicket	mana pool
Firebolt	flashback
Firecat Blitz	flashback
Fires of Undeath	flashback
Fissure Vent	choose
Flames of the Firebrand	divided damage
Flaming Gambit	flashback
Flaring Pain	flashback
Flash Flood	choose
Flash of Defiance	flashback
Flash of Insight	flashback
Fledgling Mawcor	morph
Flooded Grove	mana pool
Folk Medicine	flashback
Food Chain	mana pool
Forbidden Alchemy	reveal
Forsee	scry > 1
Fortify	choose
Fortune Thief	morph
Fountain of Cho	mana pool
Frogmite	cost modification
Frogtosser Banneret	cost modification
Frontline Strategist	morph
Frost Breath	multiple targets
Fuel for the Cause	multiple targets
Fulgent Distraction	multiple targets
Funeral Charm	choose
Fungal Behemoth	suspend
Fungal Reaches	mana pool
Fury Charm	choose
Fyndhorn Elder	mana pool
Gaea's Blessing	multiple targets
Gaea's Cradle	mana pool
Gaea's Touch	mana pool
Garruk Relentless	transform
Garruk, Caller of Beasts	reveal
Gathan Raiders	morph
Gather Courage	convoke
Gatstaf Howler	transform
Gatstaf Shepherd	transform
Gauntlet of Might	mana pool
Gauntlet of Power	mana pool
Gaze of Justic	flashback
Geistflame	flashback
Gemstone Array	mana pool
Geosurge	mana pool
Geothermal Crevice	mana pool
Ghostform	multiple targets
Ghoulcaller's Chant	choose
Giant Dustwasp	suspend
Gibbering Hyenas	blocking restriction
Gilded Lotus	mana pool
Gitaxian Probe	reveal
Glarewielder	multiple targets
Glissa Sunseeker	mana pool
Gloom	cost modification
Glowrider	cost modification
Gnaw to the Bone	flashback
Goblin Clearcutter	mana pool
Goblin Electromancer	cost modification
Goblin Guide	reveal
Goblin Ringleader	reveal
Goblin Taskmaster	morph
Goblin Warchief	cost modification
Goblin Welder	multiple targets
Golgari Charm	choose
Golgari Rot Farm	mana pool
Golgari Signer	mana pool
Grab the Reins	choose
Grafdigger's Cage	can't enter/cast
Grafted Wargear	becomes unattached
Grand Arbiter Augustin IV	cost modification
Grand Architect	mana pool
Grasp of Phantoms	flashback
Gravecrawler	from graveyard
Gravegouger	multiple targets
Gravel Slinger	morph
Graven Cairns	mana pool
Greater Gargadon	suspend
Green Mana Battery	mana pool
Greenweaver Druid	mana pool
Grim Affliction	multiple targets
Grim Discovery	choose
Grim Lavamancer	multiple targets
Grim Monolith	mana pool
Grinning Demon	morph
Grinning Ignus	mana pool
Grisly Salvage	reveal
Grixis Charm	choose
Grizzled Outcasts	transform
Grizzly Fate	flashback
Gruul Charm	choose
Gruul Signet	mana pool
Gruul Turf	mana pool
Guardian of Vitu-Ghazi	convoke
Gyre Sage	mana pool
Hall of the Bandit Lord	mana pool
Hanweir Watchkeep	transform
Harabaz Druid	mana pool
Harrow	multiple targets
Haunted Cadaver	morph
Havenwood Battleground	mana pool
Headhunter	morph
Healing Leaves	choose
Healing Salve	choose
Heartbeat of Spring	mana pool
Hearth Charm	choose
Heartless Summoning	cost modification
Helionaut	mana pool
Helm of Awakening	cost modification
Henge of Ramos	mana pool
Herald of War	cost modification
Heritage Druid	mana pool
Hero of Iroas	cost modification
Heroes Remembered	suspend
Hickory Woodlot	mana pool
High Seas	cost modification
High Tide	mana pool
Hinterland Hermit	transform
Hinterland Scourge	transform
Hollow Trees	mana pool
Homicidal Brute	transform
Hope Charm	choose
Horizon Scholar	scry > 1
Hour of Reckoning	convoke
Hoverguard Sweepers	multiple targets
Howling Gale	flashback
Howlpack Alpha	transform
Howlpack of Estwald	transform
Hull Breach	choose
Huntmaster of the Fells	transform
Hurly-Burly	choose
Hydroblast	choose
Hypergenesis	suspend
Hystrodon	morph
Icatian Store	mana pool
Ice Cauldron	mana pool
Iceberg	mana pool
Immerwolf	transform
Imperial Hellkite	morph
Imperiosaur	mana restriction
Implements of Sacrifice	mana pool
Incendiary Command	choose
Incite War	choose
Increasing Ambition	flashback
Increasing Confusion	flashback
Increasing Devotion	flashback
Increasing Savagery	flashback
Increasing Vengeance	flashback
Inexorable Tide	multiple targets
Infernal Caretaker	morph
Infernal Kirin	reveal
Infernal Plunge	mana pool
Inferno Titan	divided damage
Infiltrator il-Kor	suspend
Initiates of the Ebon Hand	mana pool
Inner Fire	mana pool
Inquisition of Kozilek	reveal
Inquisitor Exarch	choose
Instigator Gang	transform
Into the Void	multiple targets
Invoke the Firemind	choose
Irini Sengir	cost modification
Ironfang	transform
Ironfist Crusher	morph
Irrigation Ditch	mana pool
Ith, High Arcanist	suspend
Ivory Charm	choose
Ivory Giant	suspend
Izzet Boilerworks	mana pool
Izzet Charm	choose
Izzet Signet	mana pool
Jace, Architect of Thought	separate into piles
Jace, Memory Adept	multiple targets
Jace, the Mind Sculptor	reveal
Jade Leech	cost modification
Jet Medallion	cost modification
Jhoira of the Ghitu	suspend
Jorage Treespeaker	mana pool
Journey of Discovery	choose
Judge Unworthy	scry > 1
Jund Charm	choose
Jungle Basin	mana pool
Kaervek's Torch	cost modification
Kaleidostone	mana pool
Karametra's Acolyte	mana pool
Karn Liberated	restart the game
Karona's Zealot	morph
Karoo	mana pool
Kavu Primarch	convoke
Keeper of Progenitus	mana pool
Keldon Halberdier	suspend
Khalni Gem	mana pool
Knight of Sursi	suspend
Knotvine Mystic	mana pool
Koskun Keep	mana pool
Koth of the Hammer	mana pool
Krallenhorde Killer	transform
Krallenhorde Wantons	transform
Krark-Clan Ironworks	mana pool
Krark-Clan Stoker	mana pool
Krosan Cloudscraper	morph
Krosan Colossus	morph
Krosan Drover	cost modification
Krosan Restoration	flashback
Krosan Restorer	multiple targets
Krosan Warchief	cost modification
Kruin Outlaw	transform
Kuldotha Forgemaster	multiple targets
Kyren Toy	mana pool
Lake of the Dead	mana pool
Lambholt Elder	transform
Land Tax	multiple targets
Lava Dart	flashback
Lead Astray	multiple targets
Leyline of Sanctity	begin the game with it
Leyline of the Void	begin the game with it
Leyline of Vitality	begin the game with it
Liege of the Axe	morph
Liege of the Pit	morph
Liege of the Tangle	multiple targets
Life from the Loam	from graveyard
Lifebane Zombie	reveal
Lightning Surge	flashback
Liliana of the Dark Realms	mana pool
Liliana of the Veil	separate permanents
Lingering Souls	flashback
Lion's Eye Diamond	mana pool
Liturgy of Blood	mana pool
Living Destiny	reveal
Living End	suspend
Llanowar Empath	scry > 1
Locket of Yesterdays	cost modification
Lodestone Bauble	multiple targets
Lodestone Golem	cost modification
Long-Forgotten Gohei	cost modification
Lorthos, the Tidemaker	multiple targets
Lose Hope	scry > 1
Lotus Bloom	mana pool
Lotus Blossom	mana pool
Lotus Cobra	mana pool
Lotus Vale	mana pool
Ludevic's Test Subject	transform
Luminthread Field	morph
Lush Growth	becomes basic land
Lyev Decree	multiple targets
Macabre Waltz	multiple targets
Madcap Skills	blocking restriction
Maelstrom Djinn	morph
Magma Jet	scry > 1
Magnetic Mountain	multiple targets
Magus of the Coffers	mana pool
Magus of the Vineyard	mana pool
Mana Bloom	mana pool
Mana Crypt	mana pool
Mana Cylix	mana pool
Mana Drain	mana pool
Mana Echoes	mana pool
Mana Flare	mana pool
Mana Geyser	mana pool
Mana Matrix	cost modification
Mana Prism	mana pool
Mana Seism	mana pool
Mana Short	mana pool
Mana Vault	mana pool
Manaforge Cinder	mana pool
Manamorphose	mana pool
Marath, Will of the Wild	choose
March of the Returned	multiple targets
Mark of Sakiko	mana pool
Markov Warlord	multiple targets
Marshal's Anthem	multiple targets
Marshaling Cry	flashback
Martyr of Bones	multiple targets
Martyr of Sands	reveal
Master of the Veil	morph
Mayor of Avabruck	transform
Melira, Sylvok Outcast	counters replacement
Memory's Journey	flashback
Mercadian Bazaar	mana pool
Merciless Eviction	choose
Merciless Predator	transform
Metalworker	mana pool
Metamorphosis	mana pool
Midnight Charm	choose
Mindstab	suspend
Mirari's Wake	mana pool
Mischief and Mayhem	multiple targets
Mischievous Quanar	morph
Misery Charm	choose
Mishra's Bauble	look
Mishra's Workshop	mana pool
Misinformation	multiple targets
Mistform Seaswift	morph
Mistform Shrieker	morph
Mistform Warchief	cost modification
Moan of the Unhallowed	flashback
Mogis's Marauder	multiple targets
Molten Slagheap	mana pool
Moment's Peace	flashback
Momentary Blink	flashback
Mondronen Shaman	transform
Moonmist	transform
Moonscarred Werewolf	transform
Morbid Hunger	flashback
Morbid Plunder	multiple targets
Morgue Theft	flashback
Morgue Toad	mana pool
Morselhoarder	mana pool
Mossfire Egg	mana pool
Mossfire Valley	mana pool
Mudslide	multiple targets
Mul Daya Channelers	mana pool
Mulch	reveal
Muraganda Petroglyphs	no abilities
Myr Moonvessel	mana pool
Myr Reservoir	mana pool
Mystic Gate	mana pool
Mystic Retrieval	flashback
Mystic Speculation	scry > 1
Mystical Teachings	flashback
Nameless One	morph
Nantuko Elder	mana pool
Nantuko Shaman	suspend
Nantuko Vigilante	morph
Naya Charm	choose
Necra Disciple	mana pool
Nefashu	multiple targets
Nightbird's Clutches	flashback
Nightfall Predator	transform
Nightmare Incursion	multiple targets
Nightscape Battlemage	multiple targets
Nightscape Familiar	cost modification
Nightveil Specter	from exile
Nihilith	suspend
Nirkana Revenant	mana pool
Noggin Whack	multiple targets
Nomadic Elf	mana pool
Notion Thief	draw replacement
Numot, the Devastator	multiple targets
Nykthos, Shrine to Nyx	mana pool
Oath of Druids	reveal
Omenspeaker	scry > 1
Omnath, Locus of Mana	mana pool
One Dozen Eyes	choose
Orcish Lumberjack	mana pool
Orochi Leafcaller	mana pool
Orzhov Basilica	mana pool
Orzhov Charm	choose
Orzhov Pontiff	choose
Orzhov Signet	mana pool
Overabundance	mana pool
Overeager Apprentice	mana pool
Overgrown Battlement	mana pool
Overgrowth	mana pool
Overlaid Terrain	mana pool
Overwhelm	convoke
Pack Hunt	multiple targets
Palladium Myr	mana pool
Panic Attack	multiple targets
Parallel Evolution	flashback
Parch	choose
Pardic Dragon	suspend
Past in Flames	from graveyard
Patron of the Wild	morph
Pearl Medallion	cost modification
Peat Bog	mana pool
Peek	reveal
Pentad Prism	mana pool
Permafrost Trap	multiple targets
Petalmane Baku	mana pool
Petrified Plating	suspend
Phage the Untouchable	cast from hand
Phthisis	suspend
Phyrexian Altar	mana pool
Phyrexian Colossus	blocking restriction
Phyrexian Revoker	name a card
Phyrexian Splicer	choose
Phyrexian Tower	mana pool
Piety Charm	choose
Pili-Pala	mana pool
Piracy Charm	choose
Pithing Needle	name a card
Plaguemaw Beast	multiple targets
Planar Gate	cost modification
Plasm Capture	mana pool
Plunder	suspend
Plunge into Darkness	choose
Polukranos, World Eater	divided damage
Ponder	reveal
Power Conduit	choose
Preordain	reveal
Priest of Gix	mana pool
Priest of Titania	mana pool
Priest of Urabrask	mana pool
Priest of Yawgmoth	mana pool
Primal Command	choose
Primal Whisperer	morph
Prismatic Lens	mana pool
Prismatic Strands	flashback
Proclamation of Rebirth	multiple targets
Profane Command	choose
Prognostic Sphinx	scry > 1
Promise of Power	choose
Prophetic Prism	mana pool
Proteus Machine	morph
Punishing Fire	from graveyard
Purify the Grave	from graveyard
Putrid Raptor	morph
Putrid Warrior	choose
Pygmy Hippo	mana pool
Pyramids	choose
Pyreheart Wolf	blocking restriction
Pyretic Ritual	mana pool
Pyroblast	choose
Pyrokinesis	multiple targets
Quicksilver Dragon	morph
Quicksilver Geyser	multiple targets
Quiet Disrepair	choose
Quirion Sentinel	mana pool
Radha, Heir to Keld	mana pool
Rag Dealer	multiple targets
Ragemonger	cost modification
Rain of Rust	choose
Rain of Thorns	choose
Rakdos Carnarium	mana pool
Rakdos Charm	choose
Rakdos Signet	mana pool
Rakdos, Lord of Riots	cost modification
Ral Zarek	multiple targets
Rally the Peasants	flashback
Rampaging Werewolf	transform
Rapid Decay	multiple targets
Rasputin, Dreamweaver	mana pool
Ravager of the Fells	transform
Raven Guild Initiate	morph
Raven Guild Master	morph
Ravenous Demon	transform
Ray of Distortion	flashback
Ray of Revelation	from graveyard
Read the Bones	scry > 1
Reality Spasm	choose
Reality Strobe	suspend
Reap	multiple targets
Reap and Sow	choose
Reap Intellect	multiple targets
Reap the Seagraf	flashback
Reap What Is Sown	multiple targets
Recantation	multiple targets
Reckless Charge	flashback
Reckless Waif	transform
Recoup	flashback
Recuperate	choose
Red Elemental Blast	choose
Red Mana Battery	mana pool
Redeem	multiple targets
Reign of Chaos	choose
Reinforcements	multiple targets
Relic Bind	choose
Relic Crush	multiple targets
Remember the Fallen	choose
Remote Farm	mana pool
Repel the Darkness	multiple targets
Restore Balance	suspend
Retribution	multiple targets
Return to Dust	mana pool
Reveillark	multiple targets
Revenge of the Hunted	all block
Riddle of Lightning	scry > 1
Rift Bolt	suspend
Riftmarked Knight	suspend
Riftwing Cloudscate	suspend
Riftwing Cloudskate	suspend
Riptide Biologist	morph
Riptide Entrancer	morph
Riptide Pilferer	morph
Riptide Survivor	morph
Rite of Flame	mana pool
Rith's Attendant	mana pool
Rith's Charm	choose
Roar of the Kha	choose
Roar of the Wurm	flashback
Rockshard Elemental	morph
Rofellos, Llanowar Emissary	mana pool
Roiling Horro	suspend
Rolling Temblor	flashback
Root Elemental	morph
Root-Kin Ally	convoke
Rosheen Meanderer	mana pool
Ruby Leech	cost modification
Ruby Medallion	cost modification
Rude Awakening	choose
Rugged Prairie	mana pool
Ruins of Trokair	mana pool
Rumbling Crescendo	multiple targets
Rushwood Grove	mana pool
Rysorian Badger	multiple targets
Sacellum Godspeaker	mana pool
Sachi, Daughter of Seshiro	mana pool
Sacrifice	mana pool
Sakiko, Mother of Summer	mana pool
Sakura-Tribe Springcaller	mana pool
Saltcrusted Steppe	mana pool
Sand Silos	mana pool
Sandstone Needle	mana pool
Sapphire Charm	choose
Sapphire Leech	cost modification
Sapphire Medallion	cost modification
Saprazzan Cove	mana pool
Saprazzan Skerry	mana pool
Sarpadian Empires, Vol. VII	enters choose color
Satyr Hedonist	mana pool
Savage Beating	choose
Saving Grasp	flashback
Scatter the Seeds	convoke
Scattering Stroke	mana pool
School of the Unseen	mana pool
Scorched Ruins	mana pool
Scorching Missile	flashback
Scorned Villager	transform
Scornful Egotist	morph
Screeching Bat	transform
Sea God's Revenge	multiple targets
Sea Scryer	mana pool
Search for Tomorrow	suspend
Searing Blaze	multiple targets
Second Sight	choose
Seedling Charm	choose
Seething Song	mana pool
Seismic Spike	mana pool
Seize the Day	flashback
Selesnya Charm	choose
Selesnya Sanctuary	mana pool
Selesnya Signet	mana pool
Semblance Anvil	cost modification
Sensei's Divining Top	reveal
Serene Remembrance	multiple targets
Serpentine Basilisk	morph
Serra's Liturgy	multiple targets
Serra's Sanctum	mana pool
Serum Visions	reveal
Sever the Bloodline	from graveyard
Shade of Trokair	suspend
Shadowblood Egg	mana pool
Shadowblood Ridge	mana pool
Shaleskin Plower	morph
Shaper Parasite	morph
Shattered Perception	flashback
Shimmering Grotto	mana pool
Shipbreaker Kraken	multiple targets
Shivan Meteor	suspend
Shivan Sand-Mage	suspend
Shizuko, Caller of Autumn	mana pool
Showe of Coals	multiple targets
Shred Memory	multiple targets
Shrine of Boundless Growth	mana pool
Shriveling Rot	choose
Siege Wurm	convoke
Silent Departure	flashback
Silent Specter	morph
Silvergill Adept	reveal
Silverpelt Werewolf	transform
Simian Spirit Guide	mana pool
Simic Charm	choose
Simic Growth Chamber	mana pool
Simic Signet	mana pool
Sin Collector	reveal
Sisay's Ring	mana pool
Skinthinner	morph
Skirge Familiar	mana pool
Skirk Commando	morph
Skirk Marauder	morph
Skirk Prospector	mana pool
Skirk Volcanist	morph
Skirsdag High Priest	multiple targets
Skittish Valesk	morph
Skull Fracture	flashback
Skullbriar, the Walking Grave	counters remain
Skullsnatcher	multiple targets
Skycloud Egg	mana pool
Skycloud Expanse	mana pool
Skyshroud Elf	mana pool
Slagstorm	choose
Slaughter Games	name card
Sleight of Hand	reveal
Slipstream Serpent	morph
Smokebraider	mana pool
Snapcaster Mage	flashback
Snapping Thragg	morph
Snarling Undorak	morph
Snowfall	mana pool
Sol Ring	mana pool
Solar Tide	choose
Soldevi Adnate	mana pool
Soldevi Excavations	mana pool
Soldevi Machinist	mana pool
Songs of the Damned	mana pool
Sootfeather Flock	morph
Sorin, Lord of Innistrad	multiple targets
Sorrow's Path	multiple targets
Soul Collector	morph
Soul Manipulation	choose
Soul Ransom	opponent activate
Soul Seizer	transform
Soul Stair Expedition	multiple targets
Soulbright Flamekin	mana pool
Spectral Searchlight	mana pool
Spectral Shift	choose
Spellskite	change target
Spellwild Ouphe	cost modification
Sphere of Resistance	cost modification
Spider Spawning	flashback
Spined Basher	morph
Spirit Flare	flashback
Spitting Gourna	morph
Splitting Headache	choose
Spoils of Evil	mana pool
Spread the Sickness	multiple targets
Spreading Seas	becomes basic land
Springjack Pasture	mana pool
Sprout Swarm	convoke
Squeeze	cost modification
Stalking Vampire	transform
Stand Firm	scry > 1
Standing Stones	mana pool
Steady Progress	multiple targets
Steel Sabotage	choose
Stinkdrinker Daredevil	cost modification
Stir the Pride	choose
Stone Calendar	cost modification
Stonybrook Banneret	cost modification
Stormscape Familiar	cost modification
Strangling Soot	flashback
Stream of Consciousness	multiple targets
Su-Chi	mana pool
Subterranean Hanger	mana pool
Sudden Storm	multiple targets
Sulfur Vent	mana pool
Sunastian Falconer	mana pool
Sundering Vitae	convoke
Sungrass Egg	mana pool
Sungrass Prairie	mana pool
Sunken Ruins	mana pool
Sunscape Familiar	cost modification
Suppression Field	cost modification
Svyelunite Temple	mana pool
Sylvan Library	choose
Sylvan Might	flashback
Tablet of the Guilds	multiple targets
Tangleroot	mana pool
Teferi's Isle	mana pool
Tel-Jilad Justice	scry > 1
Tempest Owl	multiple targets
Temple of the False God	mana pool
Temporal Cascade	choose
Terashi's Cry	multiple targets
Terastodon	multiple targets
Terrarion	mana pool
Terror of Kruin Pass	transform
Tezzeret the Seeker	multiple targets
Tezzeret's Gambit	multiple targets
Thalia, Guardian of Thraben	cost modification
Thelon's Curse	multiple targets
Thelonite Hermit	morph
Thermopod	mana pool
Think Twice	flashback
Thorn of Amethyst	cost modification
Thornscape Familiar	cost modification
Thoughtcast	cost modification
Thoughtseize	reveal
Thraben Sentry	transform
Thran Dynamo	mana pool
Thran Turbine	mana pool
Thrashing Mudspawn	morph
Thrill of the Hunt	flashback
Throne of Geth	multiple targets
Thrummingbird	multiple targets
Thunderbolt	choose
Thunderscape Familiar	cost modification
Tidal Surge	multiple targets
Tilling Treefolk	multiple targets
Timebender	choose
Timecrafting	choose
Tinder Farm	mana pool
Tinder Wall	mana pool
Titanic Bulvox	morph
Tolarian Academy	mana pool
Tooth and Nail	choose
Tormented Pariah	transform
Torpor Orb	don't cause abilities to trigger
Tovolar's Magehunter	transform
Towering Baloth	morph
Trace of Abundance	mana pool
Tracker's Instincts	flashback
Traitor's Clutch	flashback
Travel Preparations	flashback
Treespring Lorian	morph
Treva's Attendant	mana pool
Treva's Charm	choose
Triassic Egg	choose
Tribal Forcemage	morph
Trickery Charm	choose
Trinisphere	cost modification
Triton Tactics	multiple targets
Twilight Mire	mana pool
Ulasht, the Hate Seed	choose
Ulvenwald Mystics	transform
Ulvenwald Primordials	transform
Unblinking Bleb	scry > 1
Unburial Rites	from graveyard
Undead Warchief	cost modification
Unearthly Blizzard	multiple targets
Unknown Shores	mana pool
Unstable Hulk	morph
Untaidake, the Cloud Keeper	mana pool
Upwelling	mana pool
Ur-Golem's Eye	mana pool
Urborg Uprising	multiple targets
Urza's Filter	cost modification
Urza's Incubator	cost modification
Urza's Mine	mana pool
Urza's Power Plant	mana pool
Urza's Tower	mana pool
Utopia Mycon	mana pool
Utopia Sprawl	mana pool
Valleymaker	mana pool
Vedalken Engineer	mana pool
Veiling Oddity	suspend
Vendilion Clique	reveal
Vengevine	from graveyard
Venomspout Brackus	morph
Ventifact Bottle	mana pool
Verdant Eidolon	mana pool
Verdant Haven	mana pool
Vernal Bloom	mana pool
Vesuvan Shapeshifter	morph
Victimize	multiple targets
Vile Requiem	multiple targets
Village Ironsmith	transform
Villagers of Estwald	transform
Viral Drake	multiple targets
Viridian Acolyte	mana pool
Viridian Joiner	mana pool
Viscera Seer	reveal
Viscerid Deepwalker	suspend
Vision Charm	choose
Vitality Charm	choose
Voidmage Apprentice	morph
Voidmage Prodigy	morph
Volcanic Spray	flashback
Volley of Boulders	flashback
Volt Charge	multiple targets
Vorinclex, Voice of Hunger	mana pool
Voyager Drake	multiple targets
Wail of the Nym	choose
Wall of Deceit	morph
Warbreak Trumpeter	morph
Warden of Evos Isle	cost modification
Warrior's Lesson	multiple targets
Wave Elemental	multiple targets
Weathered Bodyguards	morph
Weaver of Lies	morph
Werewolf Ransacker	transform
Wheel of Fate	suspend
Whetwheel	morph
Whip-Spine Drake	morph
Whipcorder	morph
White Mana Battery	mana pool
Wild Growth	mana pool
Wild Hunger	flashback
Wildblood Pack	transform
Willbender	morph
Windbrisk Heights	look
Wingbeat Warrior	morph
Winter's Night	mana pool
Wintermoon Mesa	multiple targets
Wirewood Channeler	mana pool
Witch Engine	mana pool
Wizard's School	mana pool
Wolfbitten Captive	transform
Woodcloaker	morph
Wooded Bastion	mana pool
Workhorse	mana pool
Worldpurge	mana pool
Worn Powerstone	mana pool
Wrap in Flames	multiple targets
Xenagos, the Reveler	mana pool
Yosei, the Morning Star	multiple targets
Zhur-Taa Ancient	mana pool
Zoetic Cavern	morph
Zombie Cutthroat	morph
